#-#-#-#-#-#-#-#-#-#
#-#-#-#-#-#-#-#-#-#
#-#-#-#-#-#-#-RS*-#-#
#-#-#-#-#-#-#-RS-#-#
#-#-#-#-#-#-#-RS-#-#
#-#-RS*-RS-RSP-RS-RS-RR-#-#
#-#-#-#-#-#-#-#-#-#
#-#-#-#-#-#-#-#-#-#
#-#-#-#-#-#-#-#-#-#
#-#-#-#-#-#-#-#-#-#